2112112122122212222111121212121122111221211212222111211222111111121112111122111212122111222112121111
1XXXX1XX1XX111X1XX1X1X1XX1XX11X11X1XX1XX11X11XXX1X1XX1X111XX1XX11XXXX1XXX1XX1X11X1X1111X1X1111X1XX12
111XX1XXXXXXXXX1XXX1XXXX1XXXX1XXX11X1XXX111XXX1XX1XXX111X1XX1XXX1X11111XXX1X1XXX1X111XX1X1XXXX1X1XX1
2XX1XXX11XX1X1X1XX1X1XX1XX111XXX1XXX1X11XX1XX11X1XXX1XX11XX1X11XX1XXXXXX1XX1XXX1X1XXXX1XX11XX1X11X11
1XXX1X1XX11X1X1X111XX11XX1XXX1X1X111X1XXXX1X1X1XXX1X1X1XX11XXXXX1X1X11X1X11XXXX1XX1X1X1X1XXXX11XXXX2
1XX11XX1XXXX1XX1XXXX1XXX1XXXXX111XXXX1XX111XX1XXX1X1XXXX1X1XX1X1X1XXXX1X1X1XXX1XX1X1XX1XX1XX1XXXX1X2
1X1X11X1XXX1XXXX1X11XX1XX111X1XX11XX1XX1XXX1XX1XXX1XXX111XXX11XXXX11XXX1X1XXX1XX1X1X11XX1XX1X1X11XX1
21X1XX1X1X1XX111X1XXX1X11XX111X1XXX1XXX11XXX1X11X1XX11XXXXXXX11X1XXXXXXXX1XXX1X111XXXXXXX11XX11XXX12
1X1XX1X1X1X1XXX1XXX111XX11XXXXXXX11X1X1XXX11XXXX1XX1XXXXX1XX1XX1X1XXX11XX1X1XX1XXXXXXX1X1XX11X1X1X11
1X1X1XX11XX1XX1X1XXXXXX1XX11XX1X1X1XX1XXX1X1X111XX1X11X1X1XXX1X1XXX1XX1XX1XX11XX1X1111XX1XXXXXX1XXX2
21X1X11XXX1X1XX111X1XXX1X1XX1XX1X1XX1XXX1XXX1XXXXXX1XXXX1XXX1X1X1XX1XX1XXXX1X1X1X1XXXXXX1XXX1X1X1XX1
211X1XXXX11X1X1XXX1XX11XX1X1XXX1X1X1X1X1XXX1X1XXX11XX11X111X1X1XXX11XX1X111X1X1XXX1XXXXX1XX1XX1XX112
2X1X1X11XXX1X1XXX1X1XXXX1XXX1X1XXXX11X1XXX1X1X1X1X1XXX1XXXX1X1XX11XXXXXXXXXXX1XXX1X11XX1X1XXX1XX1XX2
11X1X1X1XXX1X1XX1XXX1X111X11XXXXX11X1XX1X1XXXXX1X11X1X1XXX1XXX11XX1X1X1XX11X1XXXX11X1XX11X1X1X1XX1X2
1X1XXX1XXX1XXXXX1X11X1XXXXX1XX111X11XXXX1X1XXX1X1XXXX1XXX1X1X1X11X1XXXXXXXXX11111X1XXX1XXX1X11XX1XX1
11XX11XXX1XX1XX1X1XXXXXX1X1X11XXX1XXXXXXX1XX11X1XXXX1X1X1XX1XX1XX1X1X1XXXX1XXXXXXXXX11X1X1X1XXX1X1X1
11XXXXXX1X11X11XXX11XXX11XX1X1X11XX1XXXX11X1XX1XX111X1X1XX1XXXX11XX1XX11XXX1XXXXXXX1XXX111X1X11111X2
21XX1XX1X1X1XXXX11XXX11X1XX11XXX1X1XXXXXXX1XXX111XXX1XXX1X1XX11X111XX1X111111X1XXXX1XXXXXX1XXXXXXXX2
1XXXX11X1X1XXXX1XX111XXXXX1XX1XX1X1XXX111X1XX1XX1X1XX1X1X1XX1X11XXXX1X1XXXXXX1X11X1XXX11X1XXXX11XXX2
21X11XX1X11XX11X1XXXXX1X111XXX1XX1XXXXXXX1XXX11XX1XX1X1XX111XXXX1X1X1111X1XX1X1XX1X1X1X1XX1XX1X1X1X2
21XX111X1X1X1X11XXXX11X1XX1XX1XX1X1X1XXX1X111X11X1X11XXX1XX11XXX1XX1XXX1XXX11X1X1XX1XX1XX1XX111XX1X1
2X1XXXXX1X1XXXXX1X11X1XX1XXXXXX1XX1X1X1X11XXX1XX11XX11XX1X1XX1X1X11XXXX11XXXX11XXX1X11XX1X1XXX11XXX1
11XX1X11XX1111X1X1X1XXX1XXXX1X1XX1XXXX1XX1X1111XX1XXXXXXX1XX1X1X1XX1X1XXXXX1XX1XX1XXX1X1X1XXXXXXXX11
2XX1X1XXX1XXXX1X1XXX1XXXX1X1XX1XX1XX11X11XXXXX1XX1X11XXX1X11X1XXXX1XXXXXXXXX11X1X1X1XXXXX1XX11XXX1X2
2X1XXX1X1X1XXXX1X111X1XX11X1X1X11111XX1XX1XXX11XXX1XX1XXX1XX111XX1X1XX1XXX11XX1X11X1XXXXX1X1XX111XX2
1X11X1X1X1X1X11X1XXXX1X1XX1XX1XXXXXX1X1X1X1X1X1XXX1XXXX1X11XXXXXX1XXXX1XX1X1XXX1XX1XXX1X1XXX11XXXX12
21XXX11XXXX1XXXX1XXX1XX111XXXX1XX1XX1XX1XX11XXXX111X1X1X1XX1X1X1XXXX1XXX1XX1XXXXX1XXX1X1XXX1XX1111X1
1X1X1XX1XXXX1X1XX1XXX11XXXX1XXXX1XX11XX11XXXXXX1XXX11XX1XX11X1XX1XX1X11X11XX1X1XXXXXX11X1X11X1XXXXX1
211XXX1XX1XXXX1X1XXXXXX1X1XX1XX1XX1XXX1XX1XX11XXXX1XXXX111XXX1X11X1X1XX1X1XXX111X1XX1XXX11X1XXX1XX12
211XX11X1XXX1X11XX1XXX1X1XX1X1XX1XXX1X1XX11XXX1XXX11XXXXX11X1XXXXX1X1X11XX1X1XXXXXX1XX1XXXXXXX1XXXX2
1X1X1X1XX1X1X1X1XXX11111111X1XX1X1X1X1XX1XX111X111XX1XXX1XXX11X1X1XXX1X1X1XXX1X1111XX1X1XXX1X1XXX112
21XXXXXX111XXX11X1XXXXXXXX1X1X1XX11XXXX1X1XXXXXXXX111XX1XX1XX1X1XX11X1XX1XXX1XXXXXXX1XX1XX1XXX1XXX12
1X1X1XX1XXXXX1XX1X11XX1X1XXXX1X11X1XX1XX1XXXXX111XXX1XX1XX1XXXXXX1XX11XXXXXXXX11X1XX11X1X1X1X11X1X11
211X1XXX1X11X1XXX1XX1XXX1XXXX11XX1XXX111XX11XXXXXXXXX1X1XX1XXXX1X1XXX1X1X1X111XX1XX1XXX11XXX1XXXXXX1
2XX1XX111XXXXXXXXX1XXXXXXX1X1XX1XXXX1XX1X1XX1X1XXX1X1XX1X1X1XX1X1XX1XXXX1X1XXXXX1X1XX11X11X11XX11X12
1X1XX1XXXX1XXX1XX1XX1XXX1XXXXX1X1XX111XX1XX1XX1X1XXXX111XXX1X1X1XXXXXX1X11X1X111XXXX1X1XXXXXX11XX111
2XXXX11X1XXXXXXX1XX1X1X11X11X1XX1X1XXXXX11X1XXX1X1XXXXX11X1X1XX11XX1X1XXXX11XXXXXXX1X1XXXX1X1X1X1XX1
2XXX1XX1XX11XXX1X11X1X1XX1XX1XX1X1XXXX11XX1XXX11XXX1X11XXXXX1X1X1XX111XXX1X1XXX1X1XX1X11X1X1X11X1111
2XX11X1XX1XX1XX1XX1X1X1X11X1X11X1XX1X1XX1XXXX1XXXXXX1XX1XX11XX1X1X1XX1111XXXXXXX1XX1X1XXX11X1XXXXXX2
1XXXX1X1X1X11X1X11X11X1XXX1XXXX1XXX1XX11XXX11XX1XXX1X11X1XXXX1XX111X1XXX1X1X11XX1X1X1XXXXXX1X1XXXXX1
2XXXXX1X1XXX111XX1XXX1XXXXX1XXXXX1X1X1XXX11XXXX11X1X1X11XXXXX1X1XX1X1XXX1XX1XXX1XXX111X1XX1XXX11X111
11XX1XX1X1X1XX1XX1XX1X1X1XXX1X1X1X1XXXX11X1X1XXXX1X11XXXX1XX1X1XXXXXXX1XX1X11XX1XX1XXX1XXXX1X1X1XXX1
1X1X1X1X1X1XXXX11XX1X1XX11XX1X1XX11XXX1X1XX1XX11XX1XXXX11X1X1X11XX1XX1XX1XXXX11XX1X11XXXXX1X1XX1X111
21X1X1XX11XXXX1X1XX11XX1XXX1X111XXXX1111X1XXX1XXX11XX11XXXXX1XXXX1X11XX1X1X11XXX1XXXX1XX11X11XXXXXX2
211X1X1XX1XXXX11XX1XXXXXXX1X1XX11XXXXXX1X1XX1X1X1X1X1XXXX1X1XX1XX1XX1X1XXX1XXXX1X1X1X1X1XX1X1X1XXX12
2XX1X1X11XX111XXX1XXX1X1X1XX111XXXX1XXX1XXX1XX1XX1X1X1XX1XX111XXX1XXX1X1XX1XXX11X1X1XXXX1111XX11XXX2
2XXX1X1X1X1XXXX11XX11XX11XXXXXX1X11XX111X111XX1X11XXXXXX1X1XX1111X111XX1XXX111XXXXX1X1X1XXX1X1X1X1X1
11XX1XXX1XX11X1XX1XXXX1XX1X11X1X1XXX1XXXXXX11XX1XX1XXXX1X1X1XXXX1XXXXXX1XX1XXXXXX111XX1XX1XX1X1X1112
1X11X1X1X11X1X11X1XX1X1XX1XXX1XXX1XXXX1X11XXX11X11XX1XX1X1XX1X11XX1XXX11X1XXXXX11XX1X1X111111XX1XXX1
21X1X11X1X1XX1XX11X1XXX1XX1X1X1XX1XXX1XXXX11XX1XXXX1XX1XX1XXX1X1X1XXX1XX1XXXXX1X11X1XX1XXXXX1XXX1XX1
1X1XXXXXXX1XXXX1XX1XXX1XXX1XX1X111XXX1XX11XXX1X1X11XX11XX11XXXXX11XX1X11XX111X1XX11XXXX1XX1X1XX11X12
21X1XXX1XX1XX11XXXXX1XX11X1XX1XXXX111X1XXXXXX1XX1X1X1X1X1XX1XXXXXXXX1XXXX1XXXX1X1X1XXX1XXXXX1XXXX1X1
2XX1X111X1XX1XX1X111X11XXXXXXX1XXXXXX11X11XX11X1X1X111XX1XX1XXXXXXX1X11XXX11X1X1XXXX1X1XXXX1X1X1XX12
211X1XXXXX11X11X1XXX1XXX1XX1XX1X1XXXXXX1XXX1XXXXXX1XXXXX111XXX1X1XX1XX1X11XXXX1XXX1X1X11XX111XX1X112
1X1XXX1X11XX1XXX1X1X1X1X1X1X11111XXX1XX1XX1XX1XX1XX11XX1XXX1X1X1XXXXX1X1XXXX11X1XX1XX1XXX1XXX111XXX1
1XXX11X1XXXXXXXXX1XXXXX1X1XXXXXXXXX1XXX11XXXXXXXX11X111XX11XXXX11XXX1XXX11XXXXX1X1X1X1X111X11XXXX1X2
1X11X1XXXX1XX1X11XX1XXX11XX1X1X1X1X1XX1XXX1XXXX11X1XXX1X1XX1X1XXX1111X11XXXX1XX1XX1XXX1XX1XXX1XX1XX1
11X1XXXX11X1XXXXXX1X1X1XX11X1X1X1X1X11XX1X1XXX1XX1XX1XX1XX1X1XXX1XXXXXX11X11XX1XXXXXX11XX1XX1XX1X1X1
11XXX1X1XXXXX11111X1XXXX1X11XXX1XXX1XXX1X1XX1X111X1X1X1XX1X1111X1XXX11XXX1X11X1XXXX11XXX1X111X1X1X11
11XX1XX1X1XX1XXXXX11XXX1X1X1XXX1XXXX11XX11XX1XXXX1XXXX1X1XXXXXXX1XX1XXX1X11X1X11XX1X11X1XXXXXX1XX1X2
1X1XX1X1X11X1X1XXXXX11XXX1XXX1XX1XX1X11XX111X1XX1XX1X1XX1X1XX111X1XX1XXX1X11X1XXXX1XXXX1XXXXX1X1X1X1
11XX1XXX1XXX1X1XX1XXXXXX11X11X11XX1X1XXX1XXX1XXX1X11XX1X1XXXXXXXXXXX1X1XX1X1XX1XXX1XX1XXX1X1XX1XXXX1
2XX1XXX1XX1XX1XXX1XXX1X1XX1XXXXX1XX1X1X1XX11XX11X1XXX1X11XXXXX11XX1XXXX111X1XXXX11XX1XXX1X1XXX1X11X2
2X1X11XX111XX1XX1X1X1X1XXXX1XX1X11X1XX1XX1XXX1X11XX1X11XX1XXX1XXX1X1XX1XXX1XXXX1X1XXXX111XXXX1XXXXX2
21XXXXX1XXX11XXXXXX1XX1XXX11XX1XX11XX1XX1XXXX1XX1X1X1X1XXX1X1XX11X11X1XX11X1XX111XX1X1XX1X1XX1X1XXX1
11XXXXXXXX1XX11X1X1X1X1X11XX111XXXXXX1XXX11X1XX1X1X1XX1XX1X1XX1X1XXX1X1XXXX1X1XX1X1XX11XX1X11XX1XXX2
1X1X111X11XX1XXXXX1X1XX1X1X1XXXX1XXX1XX11XX1X1XX1X1X11X1X1X1X11X1X11X11XXX1XXX11X1XX1X1XX1XX1X11X111
21X1XXX1XXX1XXXX11XXX1X11XX1X1X1XX1X1X1XXX1XX1X11XXXXX1X1X1X1XX1XXX11X1XXX11X1X111XXXX1X11XXX1XXXXX1
1XXXXXXX1XXXX111XXX1XX1X1X1X1X1X1XX1XX1XXXXX1X1XXXXXXXXXXXX11X1XX1XXXX1X11X1XXXXXX11XX1XXXX11X1X1XX1
1X11X1X1XX111XXX1X1XX1XXXX1XXX11XXX1XX1XX1XX1X11XXXX1XXXX11XX1XX1XXXX1X1X11XX1XX11X1X11XXX1X1XX1XX11
11XX1X1XX1XXXXX1X1X11XXXX1XX1XXX1XX1X1XX1X1111XXXX11X1XX1XX1XXXX1XXX1XXXXXX1XXXXX1XX1X11XX1X1XXXX1X1
2X1X11XXX1XXXX1XX11X11XX1X1XX1XXX11X1XXX11XXX1X1XXX1XX11XX1XXXX1XX1XXXXXX11X11X1X11XXXXXX1X1X11XXXX1
2XX1X1XX1X1XX1X11X11XXX1X1XXXX111XXXX1X1XX11XX1X1XXXXXXX1X1XXX1XXX11XX1X1X11XX1X1XXXXXX1X1XX1XX1XXX1
2XXX1XX1X1XX1X1XXXXX1XXX1XXX11XX1X11XXX1XXXX1XX1XXXXXXX1XXX1X1XX11XXXX1XX1XXX1XX11XX1X1XX1XX1X1XX1X1
1X111X1X11XXX1XX1XXX1X1XX1X1X11XX1XXXX1XXXXXXXX1X1XX1XX1XX1XX1X1X1XXX1XXX1XX1XX1XXXXXXX1XXX1XXXX1X12
11XX1XX1XXXX1XX11XXX1XXX1XXX1XXXXXXXX11X1X1X11X1XXXXX11XX1XX1X1X1X111X11XXX11X11XX1XX11X11XX1XX11XX1
21XX1XXX1XX11X1XXXX1XXX11XX1XXXX111X1X1X1XX1XX11X1XXXXXXX11XXXX1XXXXX1XXX1XXXXX1X1XX1XX1X1XX11XX1XX1
21X1XXX1XX1XX1XXX11XXXXX11111XX1XX1X111XXX1XX1XX1XXX1X111XXX1X1XXXX11XX11X11XXXXX1X1XX1X1XX1XXX1XX12
2X1XXX1X1X1X11X11X11XXX1XXXXX111X1XXXXX11X1X1X11X1111XXXXXX1XX1XXX1XX11X1XXXX1X11X1XX1XXXXXX111X1XX2
1X1XXX11XXXXXXXXXXXX111XX1X11XXX11XXXXXX11111XX11XXX1X1XXXXXXXX1X11X1X11XXX1X11XX1XXX1X1XXX1XXX11XX1
11XX11XX1X1XX1XX1X11XXX11X1XX1XXXX1XX1XXXXXXXX1XX1X11XX1X1XX111X1XXX1XX1X11X1XX1XXX1XX1X1X11XX1XXXX1
2XX1XXX1XXXX1XX111XX1X1X1XXX11XX11X1XXX1XXXXX1XX1XXX1X1XX1XXXXXX1X111X1X1X1XXX1XX1X1XX1XX1XX1XXXXXX1
1XXX11XX1XX1X11XXXXXXXX11XX1XXXXX1XX1X1X1X11X1XX1XX1X1XX1XX1XXX1X1XXXX1XXXXXX1XXXX11XX1XX1XXXX1XXX12
2XX1XX11XXXXXXXXX1X1XX1XX1X1X1XXXX11XX1XX1XX1X11XX1XX1X1XX1X1XX1X11XXXX1X1X1X1XX1XX1X1X11XXXX1XX1X12
21XX1XX1X1X11X1XXX1X11XX11XXXX1X11XX1X1X11X1X1XXX1X1XX1X1XX1XX1X1XXXX11XXXX1XXX11X1X1X1XXX1X1XX1X1X1
11X1X1X111XXXXX1XXX1X1X1XX1XXXX1XXXXX1XXXX111X111XX1X11X1X1X1XXX1X111XXX1X1X1X1XX1XXX1XXXXX1XX11XXX2
1XXXXXXXX1XX11X1111XX1XX11X11X1XX1X1XXXXXXXXX1XXX1XX1X1XX1XXX111X1XX1XX1X1XXXX1XXX1X1XXX1X1XXXX1XX11
1XX1X1X1111XXX1XXX1X1XX1XXXXX1XXX1XXX1XXX1X111X1XXXXXXX1X11X1XXXXXXXX1XX11X111XXX11XXX1XX11XXX1XX1X1
1XX11X1XXXXXXXX1XXX1XXXXXX11XXXX1X1X1XXXX1XXX1X1XXXXXX1XXXX11XX11X1X11X1XXXXX1XXXX11XX111XX111XX1XX2
21XXX1XXXX1XXXX1XXX1X11XX1X11111X1X1X1X111X1X11X1XXXX1X1XX1X1X1XXX1XXX11XX1X1X1XX1XX11XX11XXXX1XX112
1X1X1X1X11X1111XXX1XXXXX11XXXXX1X1X1XX1XXXX11X1XXXXX1X1XX11XX1X1111111XX1X1X11XXXXX1XXX1XXX11XXX1XX1
2XX1XXX1XX1XXXX1X1XX1XX1X1XX111XX1XX11XXXX1XX1X1X1X1X1X11XXXX1XXXXXXXX1XX1X1X1X1XX1X1X111X1XXX11X1X2
1XXXXX11X1XX1X1X1XX1XX1XXX1XXX1X1X11XXX1X1X11X11XX11XXXXXXXX1X1XXXXX11X1XX1X1XX1XXX1XXXX1XXXX1XXXXX1
11XXX1XX1XXXX1XXX11X1XX11X11XX1X11X1111X11XXX1XXX1X1XXXX1X111XX1XXX1XXXX1X1X11X1XXX11XXXX1XX1XX1X1X1
1X1X1X1XX1XX1XX1XXX1XXXXX1X1XXX1XXXXXXXXXXX11XX1XX1111X1X1XX1XX11XXX11X1XX11XXXX1X1X11XXXXXXXX111X11
11X111XX1X1XX1X1XXX111X1X1XXXXX1XX1X1XXX11XXXXXX1XXXXXXX11X1XX1XX1XXXX11X1XXXX11X1XXX1X1X11XX1XXX1X2
11XXXXX1XXX1X1X11X1XX1X1X1X11X1XX1XX1XX1XX1XX111X11XX1X1XX1X1X1X1X1XX1X1XXXXX1XXX1XXXX1XXXX1XXX1XX12
2XX1X1X1X11X1X1XXXXXXX1XX11XX11XXX1XXX1X1XXXXXX1XXX11XXX111XX11X1XXX1XXX1X1XXXXX1XXX11XX111XXX1X11X2
2XX1X1XX1XX11X11XXXX11X1XXX11XXX11X1X1XX1XX1111X1XXX11X1XXX11XXX1XXX1X111X11XXX1X1X1X1X1XX1X1X1XX1X2
1112121121121122221122122222221122221111221222212221212221221211212121221221121212121212121121121122
